00000000000000000000
11110000000000001111
11100000000000000111
11000000000000000011
11000000000000000011
11000000000000000000
11000000000000000011
11000000000000000011
11100000000000000111
11110000000000001111
11111111111111111111