01111000000000011111
01000000000000000004
01000000000000000004
01000000000000000004
00000000000000000004
00000000000000000001
00000000000000000001
01000000000000000001
01110000111100001111
01111111111111111111
01111111111111111111