11111111111111111111
11110000000000110001
11110000000000000000
11110000000000000000
11110000000000000000
11110000000000000000
11110000000000000000
11110000000000000000
11110000000000000000
11110000000000110001
11111111111111111111