01111100000000111111
00111000000000011111
00000000000000000111
00000000000000000111
00000000000000000202
00000000000000000202
00000000000000000202
00000000000000000111
00000000000000000111
00111000000000011111
01111100000001111111