11111111111111111111
10000000111100000001
10000000000000000001
10000000000000000001
10000000000000000001
10000000000000000001
10000000000000000001
10000000000000000001
10000000000000000001
11111000000000011111
00000000000000000000