11111111111111111111
11110000000000110000
11110000000000000000
11110000000000000000
11110000000000000000
11110000000000000000
11110000000000000000
11110000000000000000
11110000000000000000
11110000000000110000
11111111111111111111