11111111111111111111
11110000000000001111
11110000000000001111
11110000000000001111
11110000000000001111
11110000000000001111
11110000000000001111
11110000000000001111
11110000000000001111
11111100000000111111
00000000000000000000