01111111111111111111
00010001111110000101
00000000111100000001
00000000011000000001
00000000000000000001
00000000000000000001
00000000000000000001
00000000011000000001
00000000111100000001
00010001111110000101
01111111111111111111