01111111111111111111
00000000000011111111
00000000000000011111
00000000000000000011
00000000000000000011
01100000000000000011
01100000000000000011
01100000000000000011
01100000000000000011
01100000000000000011
01111000000000011111