01111000000000011111
01100000000000000111
00000000000000000001
00000000000000000001
00000000000000000001
00000000000000000001
00000000000000000001
00000000000000000001
01000000000000000011
01111000000000011111
00000000000000000000