11111111111111111110
11111114000000000000
11111114000000000000
11111204000000000000
10020204000000000000
10020204100000000000
10020204000000000000
11111204000000000000
11111114000000000000
11111114000000000000
00000000000000000000