01111111333311111111
01110000000000000111
01100000000000000011
00000000000000000001
00000000000000000002
00000000000000000002
00000000000000000002
00000000000000000001
01100000000000000011
01110000000000000111
01111111111111111111