11111111111111111110
00000000000000011110
00000000000000000000
00000000000000000000
10000000000000000000
10000000000000000000
10000000000000000000
00000000000000000000
00000000000000000000
00000000000000011110
01111111111111111110