11111111111111111111
11100000000001111111
10000000000001111111
10000000000000000004
10000000000000000004
10000000000000000004
10000000000000000004
10000000000001111111
11100000000001111111
11111110000001111111
00000000000000000000