01111100000000011111
01100000000000000011
01000000000000000001
01000000000000000001
00000000000000000001
00000000000000000001
00000000000000000001
01000000000000000001
01000000000000000011
01100000000000000111
01111111111111111111