11111110000001111111
11110000000000001111
11000000000000000011
11000000000000000011
11000000000000000011
11000000000000000011
11000000000000000011
11111000000000011111
11111100000000111111
11111111000011111111 
11111111111111111111