11111100000000111111
11111122222222111111
11100100000000100111
11000122222222100011
10000000000000000001
00000000000000000000
10000000000000000001
11000000000000000011
11000000000000000011
11111100000000011111
00000000000000000000