11111111111111111111
11000000000000000011
10000000000000000001
40000000000000000001
40000000000000000001
40000000000000000001
11111110000000000001
11111110000000000011
11111110000000000111
11111100000000111111
00000000000000000000