00000000000000000000
00000000000000011111
00000000000000001111
00000000000000000111
00000000000000000011
00000000000000000001
00000000000000000011
00000000000000000111
00000000000000001111
00000000000000011111
01111111111111111111