11111111111111111111
11100000000000000111
11000000000000000011
10000000000000000001
10000000000000000000
10000000000000000000
10000000000000000000
10000000000000000001
10000000000000000001
11111111000011111111
00000000000000000000