00000000000000000000
00111111100111111100
00011111000011111000
00001110000001110000
00000100000000100000
00000000000000000000
00000100000000100000
00001110000001110000
00011111000011111000
00111111100111111100
00000000000000000000