11111111111111111111
10000400000000011111
10000400000000001111
10000400000000001111
10000400000000001111
11111100000000000000
11111100000000000011
11111100000000000011
11111100000000000011
11111100000000000011
11111111111111111110