11111111111111111111
11100000000000000111
10000000000000000001
10000000000000000004
10000000000000000004
10000000000000000004
10000000000000000004
10000000000000000004
11100000000000000111
11111110000000111111
00000000000000000000