11111111111111111111
10000000000000010002
10000000000000000002
10000000000000000002
10000000000000000001
10000000000000000003
10000000000000000003
10000000000000000004
10000000000000000004
10000000000000000004
11111111111111111111