11111111111111111111
20000000000000001001
20000000000000000001
20000000000000000001
10000000000000000001
30000000000000000001
30000000000000000001
00000000000000000001
00000000000000000001
00000000000000000001
11111111111111111111