10000111000000000111
10000100000000000001
10000110000000000011
10000111000000000111
10000111100000001111
10000111110000011111
10000111100000001111
10000111000000000111
10000110000000000011
10000111111111111111
00000000000000000000