01111111111111111111
00111111000000000001
00001111000000000001
00000000000000000001
00000000000000000001
00000000000000000001
00000000000000000001
00000000000000000001
00001111000000000001
00111111000000000001
01111111111111111111