10000111111111111110
10000111111111111110
10000000000000000000
10000000000000000000
10000000000000000000
10000000000000000110
10000000000000000000
11100000000000000000
11110000000000000000
11111111111111111110
11111111111111111110