11111111111111111111
00000000000000000001
00000000000000000001
00000000000000000001
00000000000000000001
00000000000000000001
00000000000000000001
00000000000000000001
00000000000000000001
00000000000000000001
01111111111111111111