11111111111111100001
11111111111111100001
00000020000000000001
00000020000000000001
00000020000000000001
11111111111111100001
00000030000000000001
00000030000000000001
00000030000000000001
11111111111111111111
11111111111111111111