00000000000000000000
00000001111000010000
00000001110000110000
00000001100001110000
00000001000011110000
00000001000010000000
00000001000010000000
00000001000010000000
00000001000010000000
00000001000010000000
00000000000000000000