11111111111111111111
11111111110000000000
11111111000000000000
11111100000000000000
11100000000000000000
11100000000000000000
11100000000000000000
11111100000000000000
11111111000000000000
11111111110000000000
11111111111222211111