11111111111111111110
10000000040000000000
10000000040000000000
10000000040000000000
10000000040000000000
11111111110000000000
10000000000000000000
10000000000000000000
10000000000000000000
10000000000000000000
00000000000000000000
00000000000000000000