00000000000000000000
11111000001111111111
10000000001111111111
10000000001111111111
10000000001111111111
10000000001111111111
10000000000000000000
10000000000000000000
10000000000000000000
11111111111111111111
11111111111111111111