01111111111111111111
00000000000000001111
00000000000000001111
00000000000000001111
00000000000000001111
00000000000000001111
00000000000000001111
00000000000000001111
00000000000000001111
00000000000000001111
01111000001111111111