01111111111111111111
01111111111111111111
00000000000000000011
00000000000000000011
00000000000000000000
00000000000000000000
00000000000000000000
00000000000000000011
00000000000000000011
01111111111111111111
01111111111111111111