01111111111111111111
01000000000000000011
01000000000000000011
01000000000000000011
00000000000000000011
00000000000000000011
00000000000000000011
01000000000000000011
01000000000000000011
01000000000000000011
01111111111111111111