01111111111111111111
01111111111111111111
01111111111111111111
01000000000000000001
00000000000000000000
00000000000000000000
00000000000000000000
01000000000000000001
01111111111111111111
01111111111111111111
01111111111111111111