01111110000011111111
01111110000011111111
01000000000000000011
01000000000000000011
00000000000000000044
00000000000000000044
00000000000000000044
01000000000000000011
01000000000000000011
01111111111111111111
01111111111111111111