01111111111110000000
00000000000010000000
00000000000010000000
00000000000010000000
00000000000010000000
00000000000010000000
00000011111110000000
00001111111110000000
00111111111110000000
01111111111110000000
01111111111110000000