00000000000000000000
00000000000000000000
00000000000000000000
11111111111111111111
10000000000000000001
00000000000000000001
10000000000000000001
11100000000000000001
11100000000000000001
11110000000000000001
11111111111111111111