01111111111110000000
00000000000010000000
00000000000010000000
00000000000010000000
00000000000010000000
00000000000010000000
00000111111110000000
00011111111110000000
01111111111110000000
01111111111110000000
01111111111110000000