00000000000000000000
10000000000000000001
10000000000000000001
10000000000000000001
10000000000000000001
10000000000000000000
11100000000000000111
11110000000000001111
11111000000000011111
11111100000000111111
11111112222221111111