00000000000000000000
10000000000000000001
10000000000000000001
10000000000000000001
10000000000000000001
10010000000000001001
10000000000000000001
10000000000000000001
10000000000000000001
10000000000000000001
11111111111111111111