10000000000000000000
10000000000000000001
10000000000000000001
10000000000000000001
10000000000000000001
10000000000000000000
10000000000000000001
10000000000000000001
10000000000000000001
10000000000000000001
11111444444444411111