11111111111111111110
10000000000000000000
10000000000000000000
10000000000000000000
10000000000000000000
00000000000000000000
10000000000000000000
10000000000000000000
10000000000000000000
10000000000000000000
11111111111111111110