10000000000000000000
10000000000000000001
10000000000000000001
10000000000000000001
10000000000000000001
10000000000000000000
10000000000000000001
11000000000000000011
11100000000000000111
11110000000000001111
11111444444444411111