11111111111111111111
11111111111111111111
00000000000000000002
00000000000000000002
00000000000000000002
00000000000000000002
00000000000000000011
00000000000000000111
00000000000000001111
00000000000000011111
00000000000000111111