11111111111111111111
11111111110000000001
11111111000000000001
11111100000000000001
11100000000000000001
11100000000000000000
11100000000000000001
11111100000000000001
11111111000000000001
11111111110000000001
11111111111111111111